00000000000000
00000000000000
11111111111111
12200100000111
12200103003001
12200131111001
12200004011001
12200101003011
11111101130301
11103003030301
11100001000001
11111111111111
00000000000000
00000000000000